%默认密码%
%高频密码%
%高频词汇%
%用户电话%
%设备类型%
%企业名称%
%企业名称%%设备类型%
%服务名称%
%产品名称%
{re=exrex:(%管理标志%|%用户标志%)}$%用户姓名%
%应用名称%
%企业名称%{re=exrex:(%管理标志%|%用户标志%)}$
%用户姓名%
%用户姓名%%账号序号%
%用户姓名%%企业名称%
%部门类型%
%访客标志%
%高频数字%
%测试手机%
%管理标志%
%默认账号%
%权限级别%
%特定用途%
%应用类型%
%用户标志%
%账号序号%
%职位类型%
%权限级别%%账号序号%
%权限级别%%高频数字%
%权限级别%{re=exrex:(%管理标志%|%用户标志%)}$
%应用类型%{re=exrex:(%管理标志%|%用户标志%)}$
%部门类型%%权限级别%
%部门类型%{re=exrex:(%管理标志%|%用户标志%)}$
{re=exrex:(%管理标志%|%用户标志%)}$%账号序号%
%用户标志%%管理标志%
