%默认密码%
%高频词汇%
%高频词汇%
%高频数字%%高频词汇%
%高频键盘%%高频数字%
%高频词汇%%高频数字%
%应用名称%%高频数字%
%USERNAME%
%USERNAME%%USERNAME%
%USERNAME%%高频符号%
%USERNAME%%高频数字%
%高频词汇%%企业名称%%
%高频词汇%%企业域名%%
%高频词汇%%产品编号%%
%应用名称%
%应用名称%%高频数字%
%企业地区%%高频数字%
%用户姓名%%时间日期%
%用户姓名%%时间日期%%追加符号%
%用户姓名%%高频数字%
%用户姓名%%用户编号%
%高频数字%%用户姓名%
%企业地区%%高频数字%%追加符号%
%企业名称%
%企业名称%%高频数字%
%企业名称%%高频词汇%
%企业名称%%时间日期%
%产品名称%%产品编号%
%企业名称%%设备类型%
%企业名称%%设备类型%%高频词汇%
%企业名称%%特殊数字%
%时间日期%%用户姓名%%追加符号%
%用户QQ%
qq%用户QQ%
%服务名称%%高频词汇%
