%用户电话%
%设备类型%
%企业名称%
%企业名称%%设备类型%
%服务名称%
%产品名称%
{re=exrex:(%管理标志%|%用户标志%)}$%用户姓名%
%应用名称%
%企业名称%{re=exrex:(%管理标志%|%用户标志%)}$
%用户姓名%
%用户姓名%%账号序号%
%用户姓名%%企业名称%