%测试权限%
%系统权限%
%管理标志%
%访客标志%
%默认账号%
%账号单词%
%测试权限%%用户标志%
%测试权限%%管理标志%
%普通权限%%用户标志%
%普通权限%%管理标志%
%系统权限%%用户标志%
%系统权限%%管理标志%
%超级权限%%用户标志%
%超级权限%%管理标志%
%用户标志%%测试权限%
%管理标志%%系统权限%
%访客标志%%测试权限%
%测试权限%%测试权限%
%系统权限%%测试权限%
%超级权限%%系统权限%
%用户标志%%管理标志%
%管理标志%%用户标志%
%访客标志%%用户标志%
%管理标志%%追加标志%
%前缀标志%%管理标志%
%系统权限%%追加标志%
%前缀标志%%系统权限%
