%高频键盘%
%高频数字%%高频字母%
%高频词汇%%高频数字%
%高频字母%%高频数字%
%高频字母%%高频数字%
%权限等级%%高频数字%%高频字母%
%应用名称%
%企业名称%
%企业域名%
%高频数字%%企业名称%
%应用名称%%高频数字%
%高频词汇%%企业名称%
%企业名称%%时间日期%
%企业名称%%高频词汇%%时间日期%
%高频词汇%%企业域名%
%高频词汇%%时间日期%
%高频字母%%时间日期%
%高频词汇%%时间日期%
%企业域名%%高频数字%
%企业域名%%高频词汇%
%应用名称%%追加符号
%应用名称%%高频数字%%追加符号%
%应用名称%%高频数字%%追加符号%
%企业名称%%高频数字%
%企业名称%%高频数字%%追加符号%
%企业名称%%连接符号%%高频数字%
%企业名称%%高频键盘%
%企业名称%%设备类型%
%企业名称%%账号标志%
%时间日期%
%用户姓名%%时间日期%
%用户姓名%%高频数字%
%用户姓名%%高频数字%%追加符号%
%用户姓名%%连接符号%%高频数字%
%用户QQ%
qq%用户QQ%
%USERNAME%
%USERNAME%%USERNAME%
%USERNAME%%追加符号%
%USERNAME%%高频数字%
