%测试权限%
%系统权限%
%管理标志%
%访客标志%
%数字序号%
%职位类型%
%部门类型%
%技术部门%
%网站应用%
%办公应用%
%服务应用%
%网络应用%
%主机名称%
%产品名称%
%应用名称%
%服务名称%
%设备类型%
%企业名称%
%企业域名%
%用户姓名%
%用户QQ%
%用户电话%
%用户编号%
%默认账号%
%账号单词%
%测试权限%%数字序号%
%系统权限%%数字序号%
%超级权限%%数字序号%
%序号01%%测试权限%
%序号01%%系统权限%
%序号01%%超级权限%
%测试权限%%用户标志%
%测试权限%%管理标志%
%普通权限%%用户标志%
%普通权限%%管理标志%
%系统权限%%用户标志%
%系统权限%%管理标志%
%超级权限%%用户标志%
%超级权限%%管理标志%
%用户标志%%测试权限%
%管理标志%%系统权限%
%访客标志%%测试权限%
%用户标志%%数字序号%
%管理标志%%字母序号%
%管理标志%%数字序号%
%访客标志%%数字序号%
%数字序号%%管理标志%
%测试权限%%测试权限%
%系统权限%%测试权限%
%超级权限%%系统权限%
%用户标志%%管理标志%
%管理标志%%用户标志%
%访客标志%%用户标志%
%字母序号%%数字序号%
%数字序号%%数字序号%
%职位类型%%部门详情%
%网站应用%%部门详情%
%职位类型%%用户姓名%
%职位类型%%数字信息%
%职位类型%%时间日期%
%部门类型%%用户姓名%
%部门类型%%数字信息%
%部门类型%%时间日期%
%部门详情%%用户姓名%
%部门详情%%数字信息%
%部门详情%%时间日期%
%用户姓名%%职位类型%
%企业名称%%职位类型%
%企业名称%%部门类型%
%企业名称%%部门详情%
%企业地区%%职位类型%
%企业地区%%部门类型%
%企业地区%%部门详情%
%企业类型%%部门详情%
%企业名称%%企业类型%
%企业名称%%企业代码%
%企业名称%%企业区号%
%企业地区%%企业名称%
%企业名称%%网站应用%
%企业名称%%办公应用%
%企业名称%%手机应用%
%企业名称%%邮箱应用%
%企业类型%%办公应用%
%企业类型%%服务应用%
%企业名称%%产品名称%
%企业名称%%产品编号%
%企业名称%%应用名称%
%企业名称%%服务名称%
%企业名称%%设备类型%
%企业名称%%用户姓名%
%企业名称%%数字信息%
%企业名称%%时间日期%
%企业地区%%用户姓名%
%用户姓名%%企业名称%
%用户姓名%%企业域名%
%网站应用%%服务名称%
%服务应用%%服务名称%
%应用名称%%网站应用%
%应用名称%%服务应用%
%服务名称%%服务应用%
%办公应用%%用户姓名%
%服务名称%%用户姓名%
%服务名称%%数字信息%
%服务名称%%时间日期%
%操作系统%%用户姓名%
%用户姓名%%数字信息%
%用户姓名%%时间日期%
%数字信息%%用户姓名%
%时间日期%%用户姓名%
%用户姓名%%用户QQ%
%用户编号%%用户姓名%
%系统权限%%部门详情%
%测试权限%%时间日期%
%系统权限%%用户姓名%
%超级权限%%用户姓名%
%管理标志%%职位类型%
%管理标志%%网站应用%
%管理标志%%办公应用%
%管理标志%%服务应用%
%管理标志%%主机名称%
%管理标志%%服务名称%
%管理标志%%企业名称%
%管理标志%%企业域名%
%管理标志%%企业区号%
%访客标志%%企业域名%
%管理标志%%用户姓名%
%管理标志%%数字信息%
%职位类型%%测试权限%
%部门类型%%测试权限%
%部门类型%%系统权限%
%部门详情%%测试权限%
%职位类型%%管理标志%
%部门类型%%用户标志%
%部门类型%%管理标志%
%部门详情%%用户标志%
%部门详情%%管理标志%
%职位类型%%数字序号%
%部门类型%%数字序号%
%部门详情%%数字序号%
%网站应用%%系统权限%
%办公应用%%测试权限%
%办公应用%%系统权限%
%手机应用%%测试权限%
%手机应用%%系统权限%
%服务应用%%测试权限%
%服务应用%%系统权限%
%网络应用%%系统权限%
%邮箱应用%%系统权限%
%网站应用%%用户标志%
%网站应用%%管理标志%
%办公应用%%用户标志%
%办公应用%%管理标志%
%手机应用%%用户标志%
%手机应用%%管理标志%
%服务应用%%用户标志%
%服务应用%%管理标志%
%网络应用%%用户标志%
%网络应用%%管理标志%
%邮箱应用%%用户标志%
%邮箱应用%%管理标志%
%网站应用%%数字序号%
%办公应用%%数字序号%
%手机应用%%数字序号%
%服务应用%%数字序号%
%网络应用%%数字序号%
%邮箱应用%%数字序号%
%主机名称%%系统权限%
%产品名称%%系统权限%
%应用名称%%系统权限%
%服务名称%%系统权限%
%设备类型%%系统权限%
%操作系统%%系统权限%
%主机名称%%管理标志%
%产品名称%%管理标志%
%应用名称%%管理标志%
%服务名称%%用户标志%
%服务名称%%管理标志%
%设备类型%%管理标志%
%操作系统%%管理标志%
%主机名称%%数字序号%
%产品名称%%数字序号%
%应用名称%%数字序号%
%服务名称%%数字序号%
%设备类型%%数字序号%
%操作系统%%数字序号%
%企业名称%%测试权限%
%企业名称%%系统权限%
%企业地区%%系统权限%
%企业名称%%用户标志%
%企业名称%%管理标志%
%企业名称%%访客标志%
%企业地区%%管理标志%
%企业类型%%管理标志%
%企业区号%%管理标志%
%企业名称%%数字序号%
%企业类型%%数字序号%
%用户姓名%%测试权限%
%用户姓名%%系统权限%
%用户姓名%%管理标志%
%用户姓名%%数字序号%
%管理标志%%追加标志%
%前缀标志%%管理标志%
%系统权限%%追加标志%
%前缀标志%%系统权限%
%前缀标志%%职位类型%
%前缀标志%%部门类型%
%前缀标志%%部门详情%
%前缀标志%%企业名称%
%用户姓名%%追加标志%
%前缀标志%%用户姓名%
%权限级别%%管理标志%%数字序号%
%管理标志%%职位类型%%数字序号%
